####################
#        P         #
#        B         #
#            @     #
####################