###########
#P        #
#  B      #
#    @    #
###########
